4 4 4 4 4 4 4 4 4 4 4 4 4 4 4 4 4 4 4 4 4 4 4 4 4 4 4 4 4 4 4 4 4 4 4 4 4 4 4 4 4 4 4 4 4 4 4 4 4 4 4 4 4 4 4 4 4 4 4 4
4 0 0 0 0 0 4 0 4 4 4 0 0 4 4 4 4 3 4 4 4 4 4 4 0 0 4 0 4 0 4 4 4 4 4 3 4 4 0 4 3 4 4 0 0 0 0 4 0 4 3 4 0 0 0 4 4 4 4 4
4 0 0 4 0 4 0 0 4 4 0 0 0 0 4 3 3 3 3 3 3 4 0 0 0 0 0 0 0 0 0 0 4 4 4 3 4 0 4 4 3 4 4 4 0 0 0 4 4 4 3 0 0 0 0 4 4 0 0 4
4 0 4 4 0 0 0 0 0 4 4 4 4 4 4 4 4 4 3 4 4 4 0 0 0 4 0 4 0 0 4 0 4 4 4 3 4 4 4 4 3 4 0 0 4 4 0 0 0 4 3 4 4 0 0 4 4 4 0 4
4 4 0 4 0 4 0 4 0 0 4 3 3 3 3 3 3 3 3 4 4 0 4 4 4 4 0 4 0 0 0 0 0 0 0 3 4 4 4 4 3 4 0 0 4 4 4 4 4 4 3 4 4 0 0 4 0 0 4 4
4 4 4 4 0 0 0 4 4 0 4 3 4 4 4 4 4 4 4 4 4 0 4 4 0 4 4 0 0 4 0 0 0 0 4 3 4 0 0 4 3 4 0 0 0 4 3 3 3 3 3 3 4 4 0 0 0 4 0 4
4 0 0 4 0 0 0 0 4 0 4 3 4 0 4 0 0 0 4 0 0 0 4 0 0 0 4 4 0 0 0 0 0 0 4 3 4 0 0 0 3 4 0 4 4 4 4 4 4 4 4 4 4 0 0 0 0 0 4 4
4 4 4 4 0 0 0 0 4 0 4 3 4 0 0 0 4 0 4 0 0 4 4 4 4 0 0 4 0 0 0 4 0 0 4 3 4 0 0 4 3 4 0 0 4 0 4 4 4 0 4 0 0 0 4 0 4 0 0 4
4 4 0 0 4 0 0 4 4 0 4 3 4 0 4 0 0 0 0 0 0 0 3 4 4 0 0 4 0 4 0 0 4 0 4 3 4 0 0 4 3 4 0 0 0 0 4 0 0 0 4 4 0 4 0 4 0 0 0 4
4 0 0 0 0 0 4 0 0 0 4 3 4 0 0 2 2 2 2 0 4 4 3 4 4 4 4 0 0 0 0 0 4 4 4 3 4 0 0 4 3 4 4 0 4 0 0 4 0 0 4 0 4 4 4 4 4 0 0 4
4 4 4 0 4 0 0 0 4 0 0 3 4 0 0 2 2 2 2 0 4 4 3 4 4 3 4 4 4 4 4 4 4 4 4 3 4 4 4 4 3 4 4 0 0 0 0 0 0 0 0 4 0 4 0 4 0 0 4 4
4 4 4 4 0 4 4 4 4 0 4 3 4 4 0 2 2 2 2 0 3 3 3 3 3 3 3 3 3 3 3 3 3 3 3 3 3 3 3 3 3 3 4 0 2 2 2 2 2 2 0 4 0 0 0 4 0 0 0 4
4 4 0 0 4 4 3 3 4 4 4 3 4 4 0 2 2 2 2 0 4 4 3 4 4 3 4 4 3 4 3 4 4 4 4 3 3 3 4 4 3 4 4 0 2 2 2 2 2 2 0 4 0 0 4 0 0 0 4 4
4 0 4 4 0 0 3 3 3 3 3 3 4 4 0 2 2 2 2 0 4 3 3 4 4 3 4 4 3 4 3 4 4 4 4 4 3 4 4 4 3 4 0 0 2 2 2 2 2 2 0 4 0 4 0 0 0 4 0 4
4 0 0 0 4 4 4 4 4 4 4 4 4 0 0 2 2 2 2 0 4 4 4 4 4 3 4 4 3 4 3 4 4 4 4 4 3 4 4 4 3 4 4 0 2 2 2 2 2 2 0 0 0 0 0 0 4 4 4 4
4 0 0 4 4 0 4 4 4 0 0 4 4 0 0 0 0 0 0 0 4 4 4 4 4 3 4 4 3 4 3 3 3 3 3 3 3 3 4 4 3 4 4 0 2 2 2 2 2 2 0 0 4 0 4 0 4 4 0 4
4 0 0 4 0 0 0 0 0 0 4 0 0 0 4 4 0 0 4 0 0 0 4 4 4 3 4 4 3 4 4 4 4 4 4 4 3 3 4 4 4 4 0 0 2 2 2 2 2 2 0 0 4 0 4 0 4 0 0 4
4 0 0 4 0 0 0 0 0 0 4 0 0 4 0 0 0 4 0 4 4 0 4 0 4 3 4 4 3 4 0 4 0 0 0 4 3 3 3 3 0 0 0 0 2 2 2 2 2 2 0 0 4 0 0 0 4 0 0 4
4 0 0 0 0 4 0 4 0 0 0 4 4 0 0 4 0 4 0 0 4 3 4 4 4 3 4 0 3 4 4 0 4 4 4 4 3 4 4 3 4 0 0 0 0 0 0 0 0 0 0 0 0 0 4 0 0 0 0 4
4 0 0 0 0 4 4 4 0 0 0 0 4 0 4 4 0 4 0 0 4 3 3 3 3 3 4 4 0 0 0 0 0 0 0 4 3 4 4 3 4 4 0 4 4 4 0 0 0 4 4 0 4 4 0 0 0 0 0 4
4 0 4 4 0 4 0 0 0 4 0 0 4 0 0 0 0 0 0 4 4 3 4 4 4 3 4 4 4 0 2 2 2 2 3 4 3 4 4 3 3 0 4 4 0 0 0 4 0 4 0 0 4 0 0 0 0 0 4 4
4 0 0 4 0 0 0 0 4 0 0 4 4 4 4 0 0 4 0 4 3 3 3 3 3 3 4 0 0 0 2 2 2 2 0 4 3 4 4 3 3 4 0 4 0 4 0 0 0 0 4 4 4 0 0 4 0 0 0 4
4 0 0 0 4 0 4 0 0 4 4 4 0 4 0 0 0 0 0 4 3 3 3 3 3 3 4 0 4 0 2 2 2 2 3 3 3 4 4 3 3 4 0 4 0 0 0 0 0 4 4 0 0 0 0 4 4 0 0 4
4 4 0 0 0 0 4 0 4 0 0 0 0 0 4 0 4 0 4 4 3 3 4 4 4 4 3 3 3 3 2 2 2 2 3 3 3 4 4 3 3 4 4 4 0 4 4 0 4 4 0 0 4 4 0 4 4 4 0 4
4 0 0 4 4 4 0 4 4 0 0 4 4 4 0 0 4 0 0 4 4 3 4 4 4 4 3 4 4 0 2 2 2 2 3 4 3 4 4 3 3 4 4 4 4 4 0 4 0 0 0 0 4 0 0 4 0 4 4 4
4 0 0 0 0 0 0 4 0 4 4 4 4 0 4 0 0 0 4 0 4 3 3 3 3 3 3 3 0 0 3 3 0 0 3 3 3 3 4 3 3 4 4 4 4 0 4 0 4 0 0 0 4 0 4 0 0 0 0 4
4 4 0 4 0 4 4 0 0 4 4 0 0 0 0 4 4 0 0 4 4 3 4 4 4 4 4 4 4 4 4 0 0 4 4 4 4 4 4 4 4 4 0 0 4 0 4 0 0 4 4 0 4 0 4 0 0 0 4 4
4 4 0 0 4 0 0 4 0 0 0 4 4 4 4 4 0 4 0 4 4 3 4 0 4 0 0 0 0 4 0 0 0 0 0 0 4 0 0 0 4 0 0 0 4 4 0 4 0 0 4 0 0 0 4 0 4 0 0 0
4 0 4 4 0 0 0 4 0 0 4 4 4 4 3 4 4 0 0 4 4 3 4 0 0 0 4 4 0 0 0 0 4 4 0 0 0 4 0 4 0 0 4 0 0 0 0 0 4 4 4 0 0 4 0 4 0 4 0 4
4 0 0 0 0 4 0 4 4 0 4 0 4 3 3 4 0 4 0 0 4 4 4 4 4 4 4 3 0 0 0 0 0 4 0 4 0 4 0 0 0 4 4 4 0 0 0 0 0 4 4 4 4 0 0 4 0 0 0 4
4 0 0 0 0 4 4 0 4 0 0 4 4 3 3 4 0 0 0 0 4 0 4 3 3 3 3 3 3 3 3 0 4 4 0 0 0 0 4 4 0 4 0 0 4 0 4 0 4 0 0 0 4 0 4 4 0 0 4 4
4 4 4 4 4 0 4 4 0 0 0 0 0 3 3 4 0 0 0 0 0 4 4 4 4 3 3 3 3 3 0 0 0 0 4 4 4 0 4 0 0 0 4 4 0 0 4 0 0 4 0 4 0 0 0 0 4 4 0 4
4 4 4 4 3 3 3 4 4 0 4 4 4 3 3 4 0 0 4 4 4 4 4 4 4 3 4 4 3 3 4 0 0 4 0 4 0 0 4 0 0 0 4 4 4 4 0 0 4 4 0 0 0 0 4 0 0 0 4 4
4 0 0 4 3 4 3 3 4 0 0 4 4 3 3 4 0 0 4 3 3 3 3 3 3 3 4 4 3 3 4 4 4 0 4 4 4 0 0 0 0 0 4 4 0 4 0 4 4 4 4 0 0 4 4 4 0 0 4 4
4 4 4 4 3 4 4 3 4 4 4 4 4 3 3 4 0 4 4 4 3 3 3 4 3 4 4 4 3 3 4 4 4 4 4 0 4 0 0 0 0 4 0 0 0 4 0 0 0 0 0 0 4 0 4 4 0 4 4 4
4 3 3 3 3 3 4 3 3 3 3 3 3 3 3 4 0 4 3 3 3 3 3 3 3 4 0 4 3 3 4 0 4 0 0 0 0 0 4 4 0 4 4 0 0 0 0 0 4 0 4 0 4 4 0 4 4 0 0 4
4 4 4 4 3 3 4 3 4 4 4 4 4 4 3 4 4 4 4 4 4 3 3 4 4 4 0 4 3 3 4 0 0 0 4 4 4 4 0 0 0 0 4 4 4 4 0 4 4 4 4 0 0 4 4 4 4 4 4 4
4 4 4 4 3 3 3 3 4 0 0 0 0 4 3 4 0 0 0 0 4 3 3 4 4 4 4 4 4 4 4 0 0 0 0 0 0 4 4 0 4 4 4 0 0 0 4 0 0 0 4 0 0 0 3 3 3 3 3 4
4 0 4 4 4 4 4 4 4 0 0 4 0 4 3 4 0 0 4 4 4 3 3 3 3 3 4 0 0 4 0 0 4 0 4 0 4 4 4 0 0 4 4 0 4 4 4 0 0 4 4 0 4 4 4 4 4 4 4 4
4 4 0 4 4 4 4 0 0 4 0 0 0 4 3 4 4 4 3 3 3 3 3 3 3 3 4 4 0 4 0 4 4 4 4 0 4 4 4 4 4 0 4 4 0 4 4 4 4 4 4 4 0 0 4 0 4 0 4 4
4 4 4 4 4 4 0 0 4 0 4 0 0 4 3 3 3 3 3 4 4 4 4 4 4 3 4 4 4 4 4 4 4 4 4 4 4 4 4 4 4 4 4 4 4 4 4 4 4 4 4 4 4 0 4 0 0 0 4 4
4 4 4 0 0 4 4 4 4 4 0 0 0 4 3 4 4 3 4 4 4 0 4 4 4 3 4 0 4 4 3 3 3 3 3 3 3 3 3 3 3 3 3 3 3 3 3 4 4 3 4 0 4 4 0 0 0 0 4 4
4 0 0 4 4 0 0 4 0 4 0 0 4 4 3 4 4 3 3 0 0 0 4 4 4 3 4 4 0 4 3 4 4 4 4 4 4 4 4 4 4 4 4 4 4 4 3 4 4 3 4 0 0 0 0 4 4 0 0 4
4 0 4 4 0 4 4 0 0 4 4 4 0 4 4 4 4 3 4 4 0 4 4 3 3 3 4 4 4 4 3 4 0 0 4 0 0 0 0 0 0 0 4 0 4 4 3 4 4 3 4 4 4 4 4 0 4 4 0 4
4 4 0 4 0 0 0 0 4 0 0 4 0 4 4 0 4 3 4 4 4 4 4 3 4 4 0 4 4 4 3 4 0 4 4 4 4 0 4 4 0 0 0 0 0 0 3 0 3 3 3 3 3 3 4 4 0 4 0 4
4 0 4 4 4 0 0 4 4 0 0 4 0 4 0 4 4 3 0 4 4 0 4 3 4 4 0 4 0 4 3 4 4 3 3 3 3 3 4 0 2 2 2 2 2 2 2 2 3 3 4 4 4 4 4 0 0 0 0 4
4 0 4 4 0 4 0 4 4 4 0 0 1 1 1 1 1 5 1 1 1 1 1 3 4 4 4 3 3 3 3 4 4 3 4 4 4 3 4 0 2 2 2 2 2 2 2 2 3 3 3 4 4 0 0 0 0 4 4 4
4 4 0 4 4 0 0 4 0 4 4 0 1 5 5 5 5 5 5 5 5 5 1 3 4 4 4 4 4 4 4 4 4 3 4 4 4 3 4 0 2 2 2 2 2 2 2 2 3 3 3 4 4 0 4 0 0 0 0 4
4 0 0 4 0 4 4 4 4 0 4 4 1 5 5 5 5 5 5 5 5 5 1 3 4 0 0 4 4 4 3 3 3 3 3 3 3 3 4 0 2 2 2 2 2 2 2 2 3 4 3 4 4 0 0 4 4 4 4 4
4 0 0 4 0 0 0 0 4 0 0 0 1 5 5 5 5 5 5 5 5 5 1 3 4 0 4 3 3 3 3 3 3 3 3 3 3 3 3 3 3 3 3 0 0 3 3 3 3 4 3 4 0 0 0 0 0 4 0 4
4 4 0 4 0 0 0 0 4 0 4 4 1 5 5 5 5 5 5 5 5 5 1 3 4 4 4 4 3 4 4 4 4 4 3 4 4 4 4 4 4 4 3 4 4 4 4 3 3 3 3 4 4 4 4 4 4 4 4 4
4 4 0 0 0 4 0 0 0 0 0 4 1 1 1 1 1 1 1 1 1 1 1 3 3 3 4 0 4 4 4 0 4 4 3 3 4 0 4 0 0 4 3 4 4 0 4 3 3 3 3 3 3 3 3 3 3 3 3 4
4 0 4 4 0 0 0 0 0 4 0 0 4 0 4 0 4 0 0 0 4 4 4 4 0 4 4 0 0 4 4 0 4 4 4 4 4 0 4 0 4 4 3 4 4 0 4 3 4 3 4 4 4 3 0 0 3 4 0 4
4 0 4 0 4 4 0 0 0 0 0 4 0 0 0 0 0 0 0 0 0 0 4 4 0 0 0 0 0 4 0 4 0 4 0 0 4 0 4 0 4 4 3 4 0 4 4 3 3 3 4 0 0 0 0 0 3 4 0 4
4 0 4 4 0 4 4 4 0 4 4 0 0 0 0 0 4 0 4 0 0 0 4 0 0 0 4 0 0 4 4 0 0 0 4 4 0 0 0 0 4 4 3 4 0 4 4 3 3 3 4 4 4 4 4 4 3 4 4 4
4 0 4 0 0 0 0 4 0 4 4 0 0 4 0 0 4 4 4 0 4 0 4 4 0 4 4 0 0 0 4 4 0 0 0 4 4 4 0 4 4 4 3 4 4 0 4 3 3 3 3 3 3 3 3 3 3 4 3 4
4 0 4 4 4 4 0 0 4 4 0 0 4 4 0 0 0 0 0 4 4 0 0 4 0 4 0 0 4 4 4 4 0 4 4 0 4 0 4 0 0 0 3 3 3 4 4 4 3 4 4 4 4 4 4 4 3 4 3 4
4 0 0 4 0 0 0 4 4 4 0 0 4 0 0 0 0 0 4 0 4 0 0 0 0 4 0 4 0 4 0 4 0 0 0 4 4 0 0 4 4 4 4 3 3 3 3 3 3 4 0 4 0 0 4 4 3 3 3 4
4 0 4 4 0 0 4 0 4 4 4 0 0 0 4 4 0 4 4 0 4 0 4 0 0 0 4 0 0 0 0 0 4 0 0 4 0 0 4 0 0 4 4 4 4 4 4 4 3 4 4 4 0 4 0 4 3 4 3 4
4 4 4 4 4 4 4 4 4 4 4 4 4 4 4 4 4 4 4 4 4 4 4 4 4 4 4 4 4 4 4 4 4 4 4 4 4 4 4 4 4 4 4 4 4 4 4 4 4 4 4 4 4 4 4 4 4 4 4 4
